24
12
7 55 55 55 55 55 55 55 55 55 55 55 55 55 55 55 55 55 55 55 55 55 55 8 
44 71 71 71 71 71 71 71 71 71 71 71 71 71 71 71 71 71 71 71 71 71 71 42 
44 71 70 71 71 71 71 71 71 71 71 71 71 71 71 71 71 71 71 71 71 71 71 42 
44 70 71 71 71 71 71 71 71 71 70 71 70 71 71 71 71 71 71 71 71 71 71 42 
44 71 71 71 71 71 71 71 71 71 71 71 71 71 71 71 71 71 71 71 71 71 71 42 
44 71 71 70 71 71 71 71 71 71 71 70 71 71 71 71 71 71 71 71 71 71 71 42 
44 71 70 71 71 71 71 71 71 71 71 85 71 71 71 71 71 71 71 71 71 71 71 42 
44 71 71 71 71 71 71 71 71 71 96 97 98 71 71 71 71 71 71 71 71 71 71 42 
44 71 71 71 71 71 71 71 71 71 108 109 110 71 71 71 71 71 71 71 71 71 71 42 
44 70 71 70 71 71 71 71 71 71 71 71 71 71 71 71 71 71 71 70 71 71 71 42 
44 71 71 71 71 71 71 71 71 71 71 71 71 71 71 71 71 71 71 71 71 71 71 42 
19 31 31 31 31 31 31 31 31 31 31 31 31 31 31 31 31 31 31 31 31 31 31 20

