19
9
33 34 34 34 34 34 34 34 34 34 34 34 34 34 34 34 34 34 35 
45 71 71 71 71 71 71 71 71 71 71 71 71 71 71 71 71 71 47 
45 71 70 71 71 71 71 71 71 71 71 71 71 71 71 71 71 71 47 
45 70 71 71 71 71 71 71 71 71 71 71 71 71 71 71 71 71 47 
45 71 71 71 71 71 71 71 30 31 31 32 71 71 71 71 71 71 47 
45 71 71 70 71 71 71 71 42 43 43 44 71 71 71 71 71 71 47 
45 71 70 71 71 71 71 71 54 55 55 56 71 71 71 71 71 71 47 
45 71 71 71 71 71 71 71 71 71 71 71 71 71 71 71 71 71 47 
57 58 58 58 58 58 58 58 58 58 58 58 58 58 58 58 58 58 59

